NO ./textures/path_to_the_north_texture/wall_text.png
SO ./textures/path_to_the_south_texture/wall_text.png
WE ./textures/path_to_the_west_texture/wall_text.png
EA ./textures/path_to_the_east_texture/wall_text.png

C 103,193,202
F 255,255,255

        1111111111111111111111111
        1000000000110000000000001
        1011000001110000000000001
        1001000000000000000000001
111111111011000001110000000000001
100000000011000001110111101111111
11110111111111010000000010001
11110111111111011101010010001
11000000110101011100000010001
1000000000000000000000010001
1000000000000000110101000001
11000001110101011111011110N0111
11110111 1110101 101111010001
11111111 1111111 111111111111
