NO ./textures/path_to_the_north_texture/wall_text.png
SO ./textures/path_to_the_south_texture/wall_text.png
WE ./textures/path_to_the_west_texture/wall_text.png
EA ./textures/path_to_the_east_texture/wall_text.png

C 52,154,255
F 56,87,35

1111111111111111111111111
        1000000000110000000000001
        1011000001110000000000001
        1001000000000000000000001
111111111011000001110000000000001
100000000011000001110001101111111
11110111111111010000010000001
11110111111111011101010010001
11000000110101011100000010001
1000000000000000000000110001
1000000000000000110101000001
11000001110101011111011110S0111
11110111 1110101 101011000001
11110111 111011 111101101111
   101     1011 111100000011
   101     10111111111111011
   101     10111111111110011
   101     101111111111100111
   101     1011111111111000111
   101     10111111111100000111
   10111111101111111111000001111
   100000000011111111100000000111
   1111111110111111111000000001111
           101111111100000000000111
           1011111111000000000001111
           10111111100000000000001111
           101111110000000000000001111
           1000000000000000000000000111
           1111111111111111111111111111
